8888888888888888
8@...g.........8
8fgf.4.agagaga.8
8......g.......8
8agagaga.4g4g448
8..............8
8agagagagaga.448
8..............8
8fgf.7g7g7g7g778
8..............8
84g4g4g4g4.agaa8
8..............8
8c.4g4g4g4g4g448
8........a.a...8
8e.e.e.e.....f#8
8888888888888888