2ffffffffffffff2
8@.............f
2ffffffffffff2.f
f............f.f
f............f.f
f.....6ffffff2.f
f.....f........f
f.....f.affffffa
f.....f........f
f.....6ffffff8.f
f............2.f
f............f.f
f............f.f
f............f.f
f............f#f
2ffffffffffff2f2