8888888888888888
8@...x.........8
88x8.8.8x8x8x8.8
8......x.......8
84x4x6x4.4x4x4x8
8..............8
86x6x6x6x6x6.6x8
8..............8
84x8.8x8x8x6x8x8
8..............8
8axaxaxaxa.axax8
8..............8
8c.cxcxcxcx8xax8
8........e.f...8
8e.e.e.e.....f#8
8888888888888888