.111111111111111
..22222222222222
...3333333333333
....444444444444
.@...55555555555
......6666666666
.......777077777
........88888888
.........9999999
.aaa......aaaaaa
...........bbbbb
............cccc
.............ddd
..............ee
RGBVYO.........f
xxxyyy..........