2gggggggggggggg2
g@.............g
2gggggggggggg2.g
.............g.g
.............g.g
.............g.g
.............g.g
.............g.g
.............g.g
.............g.g
.............g.g
.............g.g
.............g.g
.............g.g
.............g#g
.............2.2