dddddddddddddddd
d@.....GG...YY.d
dRgggR.gg.R.gg.d
d......gg.g.gg.d
d.GgGggGG.g.gg.d
d.g.G...g.g.gg.d
d.g...R.g.g.gg.d
d.g.RgR.g.g.gg.d
d.g...g.G.g.gg.d
d.g.B.g...g.gg.d
d.g.g.g.V.g.gg.d
d.g.g.g.g.R.gg.d
d.g.g.g.VgV.gg.d
d.G.g.g...B.YY.d
d...B.R.B.B...#d
dddddddddddddddd