dddddddddddddddd
d@.............d
dRRRRRRRgGGGGG.d
d............G.d
d............g.d
d............B.d
d............B.d
d............B.d
d............g.d
d............V.d
d............V.d
d............g.d
d............Y.d
d............g.d
d............g#d
dddddddddddddddd