8888888888888888
8@...R...B.....8
8..GgggG.g.....8
8....g...g.....8
8..B.R...g.....8
8..g...YgggggY.8
8..g.....g.....8
8VgggggV.g..R..8
8..B.....g..g..8
8....RggggR.g..8
8........g..g..8
8.GgYgggggG.g..8
8...g....B..g..8
8...Y......R.R.8
8...........R.#8
8888888888888888